WE                            ./textures/wall_west.xpm
NO      ./textures/wall_north.xpm



SO ./textures/wall_south.xpm

F      17,38,64

EA ./textures/wall_east.xpm



C 218, 234, 235

1111111111101111111111111
10S0110000111000000000001
1000110000000000111111001
1000110000000000110001001
1000000000100000010001001
1111111111111111111011111