NO ./textures/wall_north.xpm
SO ./textures/wall_south.xpm
WE ./textures/wall_west.xpm
EA ./textures/wall_east.xpm
DO ./textures/door.xpm

F 0,75,0
C 0,0,75

        1111111111111111111111111
        100000000D0D0000000000001
        1011000001110000000000001
        1001000000000000000000001
111111111011000001110000000000001
10000000001100000111D11111D111111
1111D111111111D11100000010001
11110111111111011101010010001
11000000110101011100000010001
10000000000000001100000010001
10000000000000001101010010N01
1100000111010101111101111000111
11110111 1110101 101111010001
11111111 1111111 111111111111
